x,x,x,x,x,x,x,x,x,x,x,x,x,x,x,x,x,x,x,x,
x,o,o,o,o,x,o,o,o,o,o,o,o,o,x,o,o,o,o,x,
x,o,x,x,o,x,o,x,x,x,x,x,x,o,x,o,x,x,o,x,
x,o,x,o,o,o,o,o,o,o,o,o,o,o,o,o,o,x,o,x,
x,o,x,o,x,x,o,x,x,g,g,x,x,o,x,x,o,x,o,x,
x,o,o,o,o,o,o,x,s,s,s,s,x,o,o,o,o,o,o,x,
x,o,x,o,x,x,o,x,x,x,x,x,x,o,x,x,o,x,o,x,
x,o,x,o,o,o,o,o,o,o,o,o,o,o,o,o,o,x,o,x,
x,o,x,x,o,x,o,x,x,x,x,x,x,o,x,o,x,x,o,x,
x,o,o,o,o,x,o,o,o,o,o,o,o,o,x,o,o,o,o,x,
x,x,x,x,x,x,x,x,x,x,x,x,x,x,x,x,x,x,x,x